SIZE 20 15
SPAWN 1 16 1
SPAWN 1 17 1
SPAWN 1 18 1
SPAWN 1 16 2
SPAWN 1 17 2
SPAWN 1 18 2
SPAWN 2 1 11
SPAWN 2 2 11
SPAWN 2 3 11
SPAWN 2 1 12
SPAWN 2 2 12
SPAWN 2 3 12

F G G F G F F F F W W F G F G W F F F G
F G F G D D D D D D D D D D D D D D G G
G F G F D F F F F G W W W F F F G D D F
F G F F D F W W G F F F W G F F G F D F
F D D D D D D F F F F F W W W F F F D F
F D F F F G D D D D D D F G W W G D D G
W D F G F W G F D F W D D D D W W D F G
F D W F F W F F D F W W W G D F W D W W
F D W W F F F G D D F W F F D D D D F W
G D G W W W W F F D D F F F D F F F G G
F D F F G F W W F G D F G F D F F G F G
F D D G W W W W D D D D D D D G F G G G
F G D D D D D D D F F F F G F F F G F G
F G F G G F F W W W F G F G G F F G F G
F G W F F F F F F W F F F F G F F F G F

D:\Git\Xadir\src>