SIZE 20 15
SPAWN 2 8 1
SPAWN 2 9 1
SPAWN 2 10 1
SPAWN 2 11 1
SPAWN 2 12 1
SPAWN 2 13 1
SPAWN 1 7 13
SPAWN 1 8 13
SPAWN 1 9 13
SPAWN 1 10 13
SPAWN 1 11 13
SPAWN 1 12 13

W W W W W W W W W W W W W W W W W W W W
W F F W G G F F G G G G G G G G G G W W
W F W W G F G G G G G F F F G F G G G W
W F W F F G F F F D D D D D F F F F G W
W W W F G G D D D D G F F D D D D F F W
W W W G D D D G F D D F F W W W D G F W
W F W W D G F F F F D W W W W F D G W W
W F F W D D F W W W D F F F W D D F W W
W W W W F D F W W F D D F F D D F F W W
W W W G D D F F W F F D D D D F F G G W
W F F F D F F F F D D D F F D G F F G W
W G G G D D D D D D F F F F D F G F F W
W W F G F F G G D D D D D D D F F G F W
W W W F F F F G G G G G G F F F G F W W
W W W W W W W W W W W W W W W W W W W W
