SIZE 20 15
SPAWN 1 16 1
SPAWN 1 17 1
SPAWN 1 18 1
SPAWN 1 16 2
SPAWN 1 17 2
SPAWN 1 18 2
SPAWN 2 1 12
SPAWN 2 2 12
SPAWN 2 3 12
SPAWN 2 1 13
SPAWN 2 2 13
SPAWN 2 3 13

G F G G G F F F G W W W G F F G F G G F
F G G F G F G F G W W W G G G F D D D F
G F G F F F G G G W W W W G F G D D D F
F F D D D D D F F W W W W W W F G D F F
F G D F G F D D D F G G G W W G F D D F
F F D F F G W D D F F D D G W W F F D G
W F D W W W W F D D D D D F W W W D D W
W W D W W W W G F D F D F G W W W D W W
W W D W W W W F D D D D D D W W W D W W
F G D G G W W F D D F F D D D F G D G F
F F D F G G W W F F G F F D D G F D F F
G F D G G G W W W W W W W F D D D D F F
F D D D F F G G W W W W W F F D F F D G
F D D D F G F G F W W W G F G F F G F F
G F G F G F G F F W W W G F F G F F G G
