SIZE 20 15
SPAWN 1 4 3
SPAWN 1 3 3
SPAWN 2 6 6

WWWW1 WWWW1 WWWW1 WWWW1 WWWW1 WWWW1 WWWW1 WWWW1 WWWW1 WWWW1 WWWW1 WWWW1 WWWW1 WWWW1 WWWW1 WWWW1 WWWW1 WWWW1 WWWW1 WWWW1
WWWW1 WWWW1 WWWW1 WWWW1 WWWW1 WWWW1 WWWW1 WWWW1 WWWW1 WWWW1 WWWW1 WWWW1 WWWW1 WWWW1 WWWW1 WWWW1 WWWW1 WWWW1 WWWW1 WWWW1
WWWW1 WWWW1 WWWW1 WWWW1 GGGG1 GGGG1 GGGG1 GGGG1 GGGG1 GGGG1 GGGG1 GGGG1 GGGG1 GGGG1 GGGG1 GGGG1 GGGG1 GGGG1 GGGG1 GGGG1
WWWW1 WWWW1 WWWW1 GGGG1 GGGG1 GGGG1 GGGG1 GGGG1 GGGG1 GGGG1 GGGG1 GGGG1 GGGG1 GGGG1 GGGG1 GGGG1 GGGG1 GGGG1 GGGG1 GGGG1
WWWW1 WWWW1 WWWW1 GGGG1 GGGG1 GGGG1 GGGG1 GGGG1 GGGG1 GGGG1 GGGG1 GGGG1 GGGG1 GGGG1 GGGG1 GGGG1 GGGG1 GGGG1 GGGG1 GGGG1
WWWW1 WWWW1 WWWW1 GGGG1 GGGG1 GGGG1 GGGG1 GGGG1 GGGG1 GGGG1 GGGG1 GGGG1 GGGG1 GGGG1 GGGG1 GGGG1 GGGG1 GGGG1 GGGG1 GGGG1
WWWW1 WWWW1 GGGG1 GGGG1 GGGG1 GGGG1 GGGG1 GGGG1 GGGG1 GGGG1 GGGG1 GGGG1 GGGG1 GGGG1 GGGG1 GGGG1 GGGG1 GGGG1 GGGG1 GGGG1
WWWW1 WWWW1 GGGG1 GGGG1 GGGG1 GGGG1 GGGG1 GGGG1 GGGG1 GGGG1 GGGG1 GGGG1 GGGG1 GGGG1 GGGG1 GGGG1 GGGG1 GGGG1 GGGG1 GGGG1
WWWW1 WWWW1 GGGG1 GGGG1 GGGG1 GGGG1 GGGG1 GGGG1 GGGG1 GGGG1 GGGG1 WWWW1 GGGG1 GGGG1 GGGG1 GGGG1 GGGG1 GGGG1 GGGG1 GGGG1
WWWW1 WWWW1 GGGG1 GGGG1 GGGG1 GGGG1 GGGG1 GGGG1 GGGG1 GGGG1 WWWW1 WWWW1 WWWW1 GGGG1 GGGG1 GGGG1 GGGG1 GGGG1 GGGG1 GGGG1
WWWW1 WWWW1 GGGG1 GGGG1 GGGG1 GGGG1 GGGG1 GGGG1 GGGG1 GGGG1 WWWW1 WWWW1 WWWW1 GGGG1 GGGG1 GGGG1 GGGG1 GGGG1 GGGG1 GGGG1
WWWW1 WWWW1 GGGG1 GGGG1 GGGG1 GGGG1 GGGG1 GGGG1 GGGG1 GGGG1 WWWW1 WWWW1 WWWW1 GGGG1 GGGG1 GGGG1 GGGG1 GGGG1 GGGG1 GGGG1
WWWW1 WWWW1 GGGG1 GGGG1 GGGG1 GGGG1 GGGG1 GGGG1 GGGG1 GGGG1 WWWW1 WWWW1 WWWW1 GGGG1 GGGG1 GGGG1 GGGG1 GGGG1 GGGG1 GGGG1
WWWW1 WWWW1 GGGG1 GGGG1 GGGG1 GGGG1 GGGG1 GGGG1 GGGG1 GGGG1 WWWW1 WWWW1 WWWW1 GGGG1 GGGG1 GGGG1 GGGG1 GGGG1 GGGG1 GGGG1
WWWW1 WWWW1 GGGG1 GGGG1 GGGG1 GGGG1 GGGG1 GGGG1 GGGG1 GGGG1 WWWW1 WWWW1 WWWW1 GGGG1 GGGG1 GGGG1 GGGG1 GGGG1 GGGG1 GGGG1
