SIZE 20 15
SPAWN 1 8 1
SPAWN 1 9 1
SPAWN 1 10 1
SPAWN 2 8 13
SPAWN 2 9 13
SPAWN 2 10 13

GGGG1 GGGG1 GGGG1 GGGG1 GGGG1 GGGG1 GGGG1 GGGG1 GGGG1 GGGG1 GGGG1 GGGG1 GGGG1 GGGG1 GGGG1 GGGG1 GGGG1 GGDG1 GDDD1 DDDD1
GGGG1 GGFG1 GGFF1 GGFF1 GGGF1 GGGG1 GGGG1 GGGG1 GGGG1 GGGG1 GGGG1 GGGG1 GGGG1 GGGG1 GGGG1 GGGG1 GGGG1 GDDG1 DDDD1 DDDD1
GGGG1 GFFG1 FFFF1 FFFF1 FGGF1 GGGG1 GGWG1 GGWW1 GGWW1 GGDD1 GGWW1 GGWW1 GGWW1 GGGW1 GGGG1 GGGG1 GGGG1 GDDG1 DDDD1 DDGD1
GGFG2 GFFF1 FFFF1 FFGF1 FGGG1 GGWG1 GWWW1 WWWW1 WWWW1 DDDD1 WWWW1 WWWW1 WWWW1 WGWW1 GGGW1 GGGG1 GGGG1 GDGG1 DDGG1 DGGG1
GFFG2 FFFF1 FFFF1 FGGF1 GGWG1 GWWW1 WWWW1 WWWW1 WWWW1 DDDD1 WWWW1 WWWW1 WWWW1 WWWW1 WGWW1 GGGW1 GGGG1 GGGG1 GGGG1 GGGG1
GFFG2 FFFF1 FFGF1 FGGG1 GWWG1 WWWW1 WWWW1 WWGW1 WWGG1 DDGG1 WWGG1 WWGG1 WWWG1 WWWW1 WWWW1 WGGW1 GGGG1 GGGG1 GGGG1 GGGG1
GFGG2 FFGG1 FGGG1 GGWG1 GWWW1 WWWW1 WWWW1 WGGW1 GGGG1 GGGG1 GGGG1 GGGG1 GWWG1 WWWW1 WWWW1 WGWW1 GGGW1 GGGG1 GGGG1 GGGG1
GGGG1 GGGG1 GGGG1 GWWG1 WWWW1 DDDD1 DDDD1 DGGD1 GGGG1 GGGG1 GGGG1 GGGG1 GDDG1 DDDD1 DDDD1 DDDD1 DGGD1 GGGG1 GGGG1 GGGG1
GGGG1 GGGG1 GGWG1 GWWW1 WWWW1 WWWW1 WWWW1 WGGW1 GGGG1 GGGG1 GGGG1 GGGG1 GWWG1 WWWW1 WWWW1 WWWW1 WGGW1 GGFG1 GGFF1 GGGF2
GGGG1 GGWG1 GWWW1 WWWW1 WWWW1 WWWW1 WWWW1 WGWW1 GGWW1 GGDD1 GGWW1 GGWW1 GWWW1 WWWW1 WWWW1 WWWW1 WGGW1 GFFG1 FFFF1 FGFF2
GGGG1 GWWG1 WWWW1 WWWW1 WWGW1 WWWG1 WWWW1 WWWW1 WWWW1 DDDD1 WWWW1 WWWW1 WWWW1 WWWW1 WWWW1 WWWW1 WGGW1 GFFG1 FFFF1 FFFF1
GGGG1 GWGG1 WWGG1 WWGG1 WGGG1 GWGG1 WWGG1 WWGG1 WWWG1 DDDD1 WWWW1 WWWW1 WWWW1 WWWW1 WWWW1 WWGW1 WGGG1 GFGG2 FFFG1 FFFF1
GGGG1 GGGG1 GGGG1 GGGG1 GGGG1 GGGG1 GGGG1 GGGG1 GWGG1 DDGG1 WWWG1 WWWW1 WWWW1 WWWW1 WWGW1 WGGG1 GGGG1 GGFG2 GFFF2 FFFF1
GGGG1 GGGG1 GGGG1 GGGG1 GGGG1 GGGG1 GGGG1 GGGG1 GGGG1 GGGG1 GWGG1 WWGG1 WWGG1 WWGG1 WGGG1 GGGG1 GGFG1 GFFF1 FFFF1 FFFF1
GGGG1 GGGG1 GGGG1 GGGG1 GGGG1 GGGG1 GGGG1 GGGG1 GGGG1 GGGG1 GGGG1 GGGG1 GGGG1 GGGG1 GGGG1 GGGG1 GFFG1 FFFF1 FFFF1 FFFF1
