SIZE 20 15
SPAWN 1 8 1
SPAWN 1 9 6
SPAWN 1 10 1
SPAWN 2 8 13
SPAWN 2 9 8
SPAWN 2 10 13

G G G G G G G G G G G G G G G G G G G D
G G G G G G G G G G G G G G G G G G D D
G G F F G G G W W D W W W G G G G G D G
G G F F G G W W W D W W W W G G G G G G
G F F G G W W W W D W W W W W G G G G G
G F G G G W W W W D W W W W W W G G G G
G G G G W W W W G G G G W W W W G G G G
G G G G W D D D G G G G D D D D D G G G
G G G W W W W W G G G G W W W W W G G G
G G W W W W W W W D W W W W W W W G F G
G G W W W G W W W D W W W W W W W G F F
G G G G G G G G W D W W W W W W G G G F
G G G G G G G G G G W W W W W G G G G F
G G G G G G G G G G G G G G G G G G F F
G G G G G G G G G G G G G G G G G F F F
