SIZE 24 14

WWWW1 WWWW1 WWWW1 WGGW1 GGGG1 GGGG1 GGGG1 GGGG1 GGGG1 GGGG1 GGGG1 GGGG1 GGGG1 GGGG1 GGGG1 GGGG1 GGGG1 GGGG1 GGGG1 GGGG1 GGGG1 GGFG2 FFFF1 FFFF1
WWWW1 WWWW1 WWWW1 WGGW1 GGGG1 GGGG1 GGGG1 GGGG1 GGGG1 GGGG1 GGGG1 GGGG1 GGGG1 GGGG1 GGGG1 GGGG1 GGGG1 GGGG1 GGGG1 GGGG1 GGGG1 GFFG1 FFFF1 FFFF1
WWWW1 WWWW1 WWGW1 WGGG1 GGGG1 GGGG1 GGGG1 GGGG1 GGGG1 GGGG1 GGGG1 GGGG1 GGGG1 GGGG1 GGGG1 GGGG1 GGGG1 GGGG1 GGGG1 GGGG1 GGGG1 GFFG1 FFFF1 FFFF1
WWWW1 WWWW1 WGGW1 GGGG1 GGGG1 GGGG1 GGFG1 GGFF1 GGGF1 GGGG1 GGGG1 GGGG1 GGGG1 GGGG1 GGGG1 GGGG1 GGGG1 GGGG1 GGGG1 GGGG1 GGGG1 GFFG1 FFFF1 FFFF1
WWWW1 WWWW1 WGGW1 GGGG1 GGGG1 GGFG1 GFFF1 FFFF1 FGFF1 GGGF1 GGGG1 GGGG1 GGGG1 GGGG1 GGGG1 GGGG1 GGGG1 GGGG1 GGGG1 GGGG1 GGGG1 GFFG1 FFFF1 FFFF1
WWWW1 WWWW1 WGGW1 GGGG1 GGGG1 GFFG1 FFFF1 FFFF1 FFFF1 FGFF1 GGGF1 GGGG1 GGGG1 GGGG1 GGGG1 GGGG1 GGGG1 GGGG1 GGGG1 GGGG1 GGFG1 GFFF1 FFFF1 FFFF1
WWWW1 WWWW1 WGGW1 GGGG1 GGGG1 GFFG1 FFFF1 FFFF1 FFFF1 FFFF1 FGGF1 GGGG1 GGGG1 GGGG1 GGGG1 GGGG1 GGGG1 GGGG1 GGGG1 GGGG1 GFFG1 FFFF1 FFFF1 FFFF1
WWWW1 WWWW1 WGGW1 GGGG1 GGGG1 GFFG1 FFFF1 FFFF1 FFFF1 FFFF1 FGGF1 GGGG1 GGGG1 GGGG1 GGGG1 GGGG1 GGGG1 GGFG2 GGFF1 GGFF1 GFFF1 FFFF1 FFFF1 FFFF1
WWWW1 WWWW1 WGWW1 GGGW1 GGGG1 GFFG1 FFFF1 FFFF1 FFFF1 FFFF1 FGGG2 GGGG1 GGGG1 GGGG1 GGGG1 GGGG1 GGGG1 GFFG1 FFFF1 FFFF1 FFFF1 FFFF1 FFFF1 FFFF1
WWWW1 WWWW1 WWWW1 WGGW1 GGGG1 GFFG1 FFFF1 FFFF1 FFFF1 FGGG2 GGGG1 GGGG1 GGGG1 GGGG1 GGGG1 GGGG1 GGFG2 GFFF1 FFFF1 FFFF1 FFFF1 FFFF1 FFFF1 FFFF1
WWWW1 WWWW1 WWWW1 WGWW1 GGGW1 GFGG2 FFGG2 FFGG2 FGGG2 GGGG1 GGGG1 GGFG1 GGFF1 GGFF1 GGFF1 GGFG1 FFFF1 FFFF1 FFFF1 FFFF1 FFFF1 FFFF1 FFFF1 FFFF1
WWWW1 WWWW1 WWWW1 WWWW1 WGGW1 GGGG1 GGGG1 GGGG1 GGGG1 GGFG1 GGFF1 GFFF1 FFFF1 FFFF1 FFFF1 FFFF1 FFFF1 FFFF1 FFFF1 FFFF1 FFFF1 FFFF1 FFFF1 FFFF1
WWWW1 WWWW1 WWWW1 WWWW1 WGWW1 GGGW1 GGGG1 GGGG1 GGFG1 GFFF1 FFFF1 FFFF1 FFFF1 FFFF1 FFFF1 FFFF1 FFFF1 FFFF1 FFFF1 FFFF1 FFFF1 FFFF1 FFFF1 FFFF1
WWWW1 WWWW1 WWWW1 WWWW1 WWWW1 WGGW1 GGGG1 GGGG1 GFFG2 FFFF1 FFFF1 FFFF1 FFFF1 FFFF1 FFFF1 FFFF1 FFFF1 FFFF1 FFFF1 FFFF1 FFFF1 FFFF1 FFFF1 FFFF1
