SIZE 20 15
SPAWN 1 9 3
SPAWN 1 10 3
SPAWN 6 6 4
SPAWN 6 7 4
SPAWN 1 9 4
SPAWN 1 10 4
SPAWN 2 12 4
SPAWN 2 13 4
SPAWN 6 6 5
SPAWN 6 7 5
SPAWN 2 12 5
SPAWN 2 13 5
SPAWN 5 6 7
SPAWN 5 7 7
SPAWN 3 12 7
SPAWN 3 13 7
SPAWN 5 6 8
SPAWN 5 7 8
SPAWN 4 9 8
SPAWN 4 10 8
SPAWN 3 12 8
SPAWN 3 13 8
SPAWN 4 9 9
SPAWN 4 10 9

G G G G G G G G G G G G G G G G G G G G
G G G G G G G G G G G G G G G G G G G G
G G G G G G G G W G G W G G G G G G G G
G G G G G G G W W D D W W G G G G G G G
G G G G G G D D W D D W D D G G G G G G
G G G G G W D D G G G G D D W G G G G G
G G G G G W W W G F F G W W W G G G G G
G G G G G W D D G G G G D D W G G G G G
G G G G G G D D W D D W D D G G G G G G
G G G G G G G W W D D W W G G G G G G G
G G G G G G G G W G G W G G G G G G G G
G G G G G G G G G G G G G G G G G G G G
G G G G G G G G G G G G G G G G G G G G
G G G G G G G G G G G G G G G G G G G G
G G G G G G G G G G G G G G G G G G G G
