SIZE 6 9

GGWG1 GGWW1 GGGW1 WWGW1 WWGG1 WWWG1
GWWG1 WWWW1 WGGW1 WGGW1 GGGG1 GWWG1
GWGG1 WWGG1 WGGG1 WGWW1 GGWW1 GWWW1
FFGF1 FFGG1 FFFG1 GGFG2 GGFF2 GGGF2
FGGF1 GGGG1 GFFG1 GFFG2 FFFF1 FGGF2
FGFF1 GGFF1 GFFF1 GFGG2 FFGG2 FGGG2
DDGD1 DDGG1 DDDG1 GGDG1 GGDD1 GGGD1
DGGD1 GGGG1 GDDG1 GDDG1 DDDD1 DGGD1
DGDD1 GGDD1 GDDD1 GDGG1 DDGG1 DGGG1
